Amigos para siempre – Los Manolos
Vertigo – U2
Dama, dama – Cecília
Always look on the bright side of life – Monty Python
Surfing USA – Beach Boys
Mama – Rigoberta Bandini
Funkytown – Lipps Inc
In the night – Oques Grasses
La bomba – King Africa
Por la boca vive el pez – Fito y Fitipaldis
La Flaca – Jarabe de Palo
Don’t stop me now – Queen
Saca el guisky, Cheli – Desmadre 75
Dancing queen – Abba
Celebrem – Miki Núñez 
Sufre mamón – Hombres G
Slomo – Chanel
YMCA – Village People
Yo quiero bailar – Sonia y Selena
Mari Carmen – La Pegatina
Fiesta de Blas – Fórmula V
Mediterráneo – Joan Manuel Serrat
20 de abril – Celtas Cortos
L’Empordà – Sopa de Cabra
Dame veneno – Los Chunguitos
Una lluna a l’aigua – Txarango
Maniac – Michael Sembello
Un beso y una flor – Nino Bravo
Boogie Wonderland – Earth, Wind and Fire
Escuela de calor - Radio Futura     
La barbacoa – Georgie Dann
La bilirrubina – Juan Luis Guerra     
Mi gran noche - Raphael
Hay que venir al Sur – Raffaella Cará 
La revolución sexual – La Casa Azul
Suavemente – Elvis Crespo
La bicicleta – Shakira y Carlos Vives
Stayin alive- Bee Gees
A-BA-Ni-Bi  - El chaval de la peca 
El muerto vivo – Los Manolos
Never gonna give you up - Rick Astley  
Marta, Sebas, Guille y los demás - Amaral 
Amante bandido – Miguel Bosé 
Oye – Gloria Estefan
Cuando tú vas – Chenoa
A quién le importa - Alaska